aeropuerto	airport
agua	water
banco	bank
buenas_tardes	good_afternoon
buenos_dias	good_morning
casa	house
comida	food
computadora	computer
gato	cat
gracias	thank_you
hermana	sister
hermano	brother
hola	hello
hospital	hospital
mama	mother
marcador	marker
necesitar	need
papa	father
pasaporte	passport
programacion	programming
telefono	telephone
tienda	store
